adminiſtering=administering
affizes=assizes
aforeſaid=aforesaid
againſt=against
alfo=also
arboreſcentes=arborescentes
arſenical=arsenical
assaffin=assassin
aſhes=ashes
aſked=asked
aſſafſination=assassination
aſſerting=asserting
aſſured=assured
aſter=after
atmoſphere=atmosphere
becauſe=because
beſide=beside
boiſterous=boisterous
brimſtone=brimstone
bruiſed=bruised
burſt=burst
businefs=business
buſh=bush
buſhes=bushes
capſules=capsules
Cardiganſhire=Cardiganshire
cauſed=caused
cenſure=censure
circumſtance=circumstance
cloſe=close
cloſely=closely
compoſed=composed
compoſition=composition
condenſation=condensation
condenſing=condensing
conſider¢d=considered
conſider=consider
conſiderations=considerations
conſiders=considers
contraſt=contrast
curiouſly=curiously
daſh=dash
decompoſition=decomposition
deriſion=derision
deſcend=descend
deſcending=descending
deſtroy=destroy
deſtruction=destruction
difeaſe=disease
difeaſes=diseases
diminiſh=diminish
diſcharged=discharged
diſcover=discover
diſguifing=disguising
diſlodge=dislodge
diſlodged=dislodged
diſpoſed=disposed
diſſect=dissect
diſſecting=dissecting
diſtances=distances
diſtemper=distemper
diſtilled=distilled
diſtinct=distinct
diſunite=disunite
duſky=dusky
duſt=dust
eaſily=easily
elaſticity=elasticity
eſcape=escape
eſcapes=escapes
eſſerveſcence=effervescence
exerciſe=exercise
exiſt=exist
expanſive=expansive
exploſions=explosions
eye-witneſs=eye-witness
eye-witneſſes=eye-witnesses
facetiouſneſs=facetiousness
falſe=false
faſl=fall
feaſons=seasons
fiſhes=fishes
fiſh-pond=fish-pond
ſor=for
foreſt-towns=forest-towns
Francifcan=Franciscan
freſli=fresh
fubſtance=substance
fubſtances=substances
fucceſsful=successful
fweeteſt=sweetest
garriſcn=garrison
geniufes=geniuses
glaſſ=glass
glaſſes=glasses
graſs=grass
hail-ſhmes=hail-stones
hail-ſtones=hail-stones
hardneſs=hardness
Herefordſhire=Herefordshire
higheſt=highest
hiſtories=histories
horſe=horse
horſemanſhip=horsemanship
hypotheſes=hypotheses
hypotheſis=hypothesis
immerſe=immerse
immerſed=immersed
immerſing=immersing
increaſe=increase
ineſtimable=inestimable
Ingolſtadt=Ingolstadt
inſertion=insertion
inſpection=inspection
inſtant=instant
inſtantly=instantly
inſtrument=instrument
inſufficient=insufficient
inteſtines=intestines
juſt=just
landſcape=landscape
land-ſeape=landscape
leaſt=least
looſe=loose
luppoſing=supposing
madneſs=madness
main-ſail=main-sail
main-ſails=main-sails
main-ſtay=main-stay
main-ſtays=main-stays
miſchief=mischief
moſt=most
Mufcles=Muscles
muſiin=muslin
myſelf=myself
naturaliſt=naturalist
naturaliſts=naturalists
neceſſiry=necessary
nervoſus=nervosus
nonſenſe=nonsense
obſcenſty=obscenity
obſervation=observation
obſervers=observers
offenſive=offensive
oppoſite=opposite
oſ=of
otherwiſe=otherwise
over-moiſture=over-moisture
paſtures=pstures
perſon=person
perſuade=persuade
perſuaded=persuaded
phlogiſtic=phlogistic
phyſician=physician
phyſicians=physicians
pictureſque=picturesque
Piſa=Pisa
poiſon=poison
preſcription=prescription
preſcriptions=prescriptions
prieſts=priests
profuſion=profusion
publiſhed=published
purpoſe=purpose
receſſes=recesses
reſiſtance=resistance
reſolve=resolve
reſpects=respects
riſe=rise
ruſty=rusty
Slleſia=Silesia
ſage=sage
ſally=sally
ſalt=salt
ſand=sand
ſar=far
ſaw=saw
ſcarce=scarce
ſcattered=scattered
ſeaſon=season
ſeen=seen
ſemicirci/ar=semicircular
ſemicircle=semicircle
ſemicircular=semicircular
ſenfibility=sensibility
ſeparated=separated
ſerves=serves
ſevere=severe
ſhade=shade
ſhake=shake
ſhare=share
ſhould=should
ſhowed=showed
ſhower=shower
ſhowers=showers
ſhowing=showing
ſhrewdneſs=shrewdness
ſide=side
ſigniſied=signified
ſigniſies=signifies
ſigniſy=signify
ſince=since
ſingle=single
ſirſt=first
ſkins=skins
ſluggiſhly=sluggishly
ſmaller=smaller
ſmell=smell
ſmoke=smoke
ſnmmit=summit
ſo=so
ſoft-bodied=soft-bodied
ſolution=solution
ſolve=solve
ſome=some
ſomehow=somehow
ſometimes=sometimes
ſomewhere=somewhere
ſor=for
ſoſt=soft
ſow-thiſtles=sow-thistles
ſpaniels=spaniels
ſpawn=spawn
ſpecifically=specifically
ſpirits=spirits
ſprats=sprats
ſpread=spread
ſrom=from
ſtanding=standing
ſtartle=startle
ſtate=state
ſtay-ſail=stay-sail
ſtay-ſails=stay-sails
ſtinking=stinking
ſtomach=stomach
ſtone=stone
ſtood=stood
ſtorm=storm
ſtraggle=straggle
ſtrange=strange
ſtranger=stranger
ſtrewed=strewed
ſtrict=strict
ſtrictly=strictly
ſtripped=stripped
ſtronger=stronger
ſtrongly=strongly
ſubject=subject
ſubſtance=substance
ſubtile=subtile
ſubtilty=subtilty
ſuch=such
ſudden=sudden
ſuddenly=suddenly
ſuffered=suffered﻿
ſuffered=suffered﻿adminiſtering=administering
ſufpecting=suspecting
ſulphur=sulphur
ſuperfluous=superfluous
ſuppofed=supposed
ſuppoſing=supposing
ſuppoſitions=suppositions
ſuppreffing=suppressing
ſurface=surface
ſuſpected=suspected
ſwaiming=swarming
ſwarms=swarms
ſyllable=syllable
ſyllables=syllables
tediouſſy=tediously﻿adminiſtering=administering
teſticle=testicle
teſticles=testicles
Theophraſtus=Theophrastus
top-ſail=top-sail
top-ſails=top-sails
tranfverſe=transverse
tranfverſely=transversely
Tranſactions=Transactions
trea-ſures=trea-sures
unanſwerable=unanswerable
Upminſ=Upmins.
Upminſter=Upminister
uſe=use
uſual=usual
variouſly=variously
vaſt=vast
veſſel=vessel
veſſels=vessels
viſible=visible
well-ſtocked=well-stocked
whoſe=whose
wiltſhire=Wiltshire
wiſl=will
